NO ./textures/poison_slime_wall(1).png
SO ./textures/trash_wall(1).png
WE ./textures/grassstone_wall.png
EA ./textures/cobbluestone_wall.png

C 16,11,38

        1111111111111111111111111
        10000000001100000N0000001
        1011000001110000000000001
        1001000000010000000000001
111111111011000001110000000000001
100000000011000001111111110111111
1111011111111101110000001000111110111111111011100000010001 
11110111111111000001010010001
11000000110101011100000010001
10000000000000000000000000001
10000000000000001101010010001
1100000111010101111101011000111
11110111 1110101 101110010001
11111111 1111111 111111111111111110111111111011100000010001 
11110111111111000001010010001
11000000110101011100000010001
10000000000000000000000000001
10000000000000001101010010001
1100000111010101111101011000111
11110111 1110101 101110010001
11111111 1111111 111111111111111110111111111011100000010001 
11110111111111000001010010001
11000000110101011100000010001
10000000000000000000000000001
10000000000000001101010010001
1100000111010101111101011000111
11110111 1110101 101110010001
11111111 1111111 111111111111111110111111111011100000010001 
11110111111111000001010010001
11000000110101011100000010001
10000000000000000000000000001
10000000000000001101010010001
1100000111010101111101011000111
11110111 1110101 101110010001
11111111 1111111 111111111111111110111111111011100000010001 
11110111111111000001010010001
11000000110101011100000010001
10000000000000000000000000001
10000000000000001101010010001
1100000111010101111101011000111
11110111 1110101 101110010001
11111111 1111111 111111111111111110111111111011100000010001 
11110111111111000001010010001
11000000110101011100000010001
10000000000000000000000000001
10000000000000001101010010001
1100000111010101111101011000111
11110111 1110101 101110010001
11111111 1111111 111111111111111110111111111011100000010001 
11110111111111000001010010001
11000000110101011100000010001
10000000000000000000000000001
10000000000000001101010010001
1100000111010101111101011000111
11110111 1110101 101110010001
11111111 1111111 111111111111111110111111111011100000010001 
11110111111111000001010010001
11000000110101011100000010001
10000000000000000000000000001
10000000000000001101010010001
1100000111010101111101011000111
11110111 1110101 101110010001
11111111 1111111 111111111111111110111111111011100000010001 
11110111111111000001010010001
11000000110101011100000010001
10000000000000000000000000001
10000000000000001101010010001
1100000111010101111101011000111
11110111 1110101 101110010001
11111111 1111111 111111111111111110111111111011100000010001 
11110111111111000001010010001
11000000110101011100000010001
10000000000000000000000000001
10000000000000001101010010001
1100000111010101111101011000111
11110111 1110101 101110010001
11111111 1111111 111111111111111110111111111011100000010001 
11110111111111000001010010001
11000000110101011100000010001
10000000000000000000000000001
10000000000000001101010010001
1100000111010101111101011000111
11110111 1110101 101110010001
11111111 1111111 111111111111111110111111111011100000010001 
11110111111111000001010010001
11000000110101011100000010001
10000000000000000000000000001
10000000000000001101010010001
1100000111010101111101011000111
11110111 1110101 101110010001
11111111 1111111 111111111111111110111111111011100000010001 
11110111111111000001010010001
11000000110101011100000010001
10000000000000000000000000001
10000000000000001101010010001
1100000111010101111101011000111
11110111 1110101 101110010001
11111111 1111111 111111111111111110111111111011100000010001 
11110111111111000001010010001
11000000110101011100000010001
10000000000000000000000000001
10000000000000001101010010001
1100000111010101111101011000111
11110111 1110101 101110010001
11111111 1111111 111111111111111110111111111011100000010001 
11110111111111000001010010001
11000000110101011100000010001
10000000000000000000000000001
10000000000000001101010010001
1100000111010101111101011000111
11110111 1110101 101110010001
11111111 1111111 111111111111111110111111111011100000010001 
11110111111111000001010010001
11000000110101011100000010001
10000000000000000000000000001
10000000000000001101010010001
1100000111010101111101011000111
11110111 1110101 101110010001
11111111 1111111 111111111111111110111111111011100000010001 
11110111111111000001010010001
11000000110101011100000010001
10000000000000000000000000001
10000000000000001101010010001
1100000111010101111101011000111
11110111 1110101 101110010001
11111111 1111111 111111111111111110111111111011100000010001 
11110111111111000001010010001
11000000110101011100000010001
10000000000000000000000000001
10000000000000001101010010001
1100000111010101111101011000111
11110111 1110101 101110010001
11111111 1111111 111111111111111110111111111011100000010001 
11110111111111000001010010001
11000000110101011100000010001
10000000000000000000000000001
10000000000000001101010010001
1100000111010101111101011000111
11110111 1110101 101110010001
11111111 1111111 111111111111111110111111111011100000010001 
11110111111111000001010010001
11000000110101011100000010001
10000000000000000000000000001
10000000000000001101010010001
1100000111010101111101011000111
11110111 1110101 101110010001
11111111 1111111 111111111111111110111111111011100000010001 
11110111111111000001010010001
11000000110101011100000010001
10000000000000000000000000001
10000000000000001101010010001
1100000111010101111101011000111
11110111 1110101 101110010001
11111111 1111111 111111111111111110111111111011100000010001 
11110111111111000001010010001
11000000110101011100000010001
10000000000000000000000000001
10000000000000001101010010001
1100000111010101111101011000111
11110111 1110101 101110010001
11111111 1111111 111111111111111110111111111011100000010001 
11110111111111000001010010001
11000000110101011100000010001
10000000000000000000000000001
10000000000000001101010010001
1100000111010101111101011000111
11110111 1110101 101110010001
11111111 1111111 111111111111111110111111111011100000010001 
11110111111111000001010010001
11000000110101011100000010001
10000000000000000000000000001
10000000000000001101010010001
1100000111010101111101011000111
11110111 1110101 101110010001
11111111 1111111 111111111111111110111111111011100000010001 
11110111111111000001010010001
11000000110101011100000010001
10000000000000000000000000001
10000000000000001101010010001
1100000111010101111101011000111
11110111 1110101 101110010001
11111111 1111111 111111111111111110111111111011100000010001 
11110111111111000001010010001
11000000110101011100000010001
10000000000000000000000000001
10000000000000001101010010001
1100000111010101111101011000111
11110111 1110101 101110010001
11111111 1111111 111111111111111110111111111011100000010001 
11110111111111000001010010001
11000000110101011100000010001
10000000000000000000000000001
10000000000000001101010010001
1100000111010101111101011000111
11110111 1110101 101110010001
11111111 1111111 111111111111111110111111111011100000010001 
11110111111111000001010010001
11000000110101011100000010001
10000000000000000000000000001
10000000000000001101010010001
1100000111010101111101011000111
11110111 1110101 101110010001
11111111 1111111 111111111111111110111111111011100000010001 
11110111111111000001010010001
11000000110101011100000010001
10000000000000000000000000001
10000000000000001101010010001
1100000111010101111101011000111
11110111 1110101 101110010001
11111111 1111111 111111111111111110111111111011100000010001 
11110111111111000001010010001
11000000110101011100000010001
10000000000000000000000000001
10000000000000001101010010001
1100000111010101111101011000111
11110111 1110101 101110010001
11111111 1111111 111111111111111110111111111011100000010001 
11110111111111000001010010001
11000000110101011100000010001
10000000000000000000000000001
10000000000000001101010010001
1100000111010101111101011000111
11110111 1110101 101110010001
11111111 1111111 111111111111111110111111111011100000010001 
11110111111111000001010010001
11000000110101011100000010001
10000000000000000000000000001
10000000000000001101010010001
1100000111010101111101011000111
11110111 1110101 101110010001
11111111 1111111 111111111111111110111111111011100000010001 
11110111111111000001010010001
11000000110101011100000010001
10000000000000000000000000001
10000000000000001101010010001
1100000111010101111101011000111
11110111 1110101 101110010001
11111111 1111111 111111111111111110111111111011100000010001 
11110111111111000001010010001
11000000110101011100000010001
10000000000000000000000000001
10000000000000001101010010001
1100000111010101111101011000111
11110111 1110101 101110010001
11111111 1111111 111111111111111110111111111011100000010001 
11110111111111000001010010001
11000000110101011100000010001
10000000000000000000000000001
10000000000000001101010010001
1100000111010101111101011000111
11110111 1110101 101110010001
11111111 1111111 111111111111111110111111111011100000010001 
11110111111111000001010010001
11000000110101011100000010001
10000000000000000000000000001
10000000000000001101010010001
1100000111010101111101011000111
11110111 1110101 101110010001
11111111 1111111 111111111111111110111111111011100000010001 
11110111111111000001010010001
11000000110101011100000010001
10000000000000000000000000001
10000000000000001101010010001
1100000111010101111101011000111
11110111 1110101 101110010001
11111111 1111111 111111111111111110111111111011100000010001 
11110111111111000001010010001
11000000110101011100000010001
10000000000000000000000000001
10000000000000001101010010001
1100000111010101111101011000111
11110111 1110101 101110010001
11111111 1111111 111111111111111110111111111011100000010001 
11110111111111000001010010001
11000000110101011100000010001
10000000000000000000000000001
10000000000000001101010010001
1100000111010101111101011000111
11110111 1110101 101110010001
11111111 1111111 111111111111111110111111111011100000010001 
11110111111111000001010010001
11000000110101011100000010001
10000000000000000000000000001
10000000000000001101010010001
1100000111010101111101011000111
11110111 1110101 101110010001
11111111 1111111 111111111111111110111111111011100000010001 
11110111111111000001010010001
11000000110101011100000010001
10000000000000000000000000001
10000000000000001101010010001
1100000111010101111101011000111
11110111 1110101 101110010001
11111111 1111111 111111111111111110111111111011100000010001 
11110111111111000001010010001
11000000110101011100000010001
10000000000000000000000000001
10000000000000001101010010001
1100000111010101111101011000111
11110111 1110101 101110010001
11111111 1111111 111111111111111110111111111011100000010001 
11110111111111000001010010001
11000000110101011100000010001
10000000000000000000000000001
10000000000000001101010010001
1100000111010101111101011000111
11110111 1110101 101110010001
11111111 1111111 111111111111111110111111111011100000010001 
11110111111111000001010010001
11000000110101011100000010001
10000000000000000000000000001
10000000000000001101010010001
1100000111010101111101011000111
11110111 1110101 101110010001
11111111 1111111 1111111111111 
11110111111111000001010010001
11000000110101011100000010001
10000000000000000000000000001
10000000000000001101010010001
1100000111010101111101011000111
11110111 1110101 101110010001
11111111 1111111 1111111111111

