NO ./textures/straw_hats.png
SO ./textures/south_wall.png
WE ./textures/west_wall.png
EA ./textures/east_wall.png

F 220,180,10
C 225,40,50

        1111111111111111111111111
        1000000000110000000000001
        10110000011100000000000011111111111111111111111111111111111111111111
        10010000000000000000000000000000000000000000000000000000000000000001
1111111110110000011100000000000011111111111111111111111111111111111111111111
100000000011000001110111110111111
11110111111111011100000010001
11110111111111011101010010001
11000000110101011100000010001
10000000000000001100000010001
10000000000000001101010000001
11000001110101011111011110N0111
11110111 1110101 101111010001
11111111 1111111 111111111111






