NO ./textures/north_wall.png
WE ./textures/west_wall.png
EA ./textures/east_wall.png
SO ./textures/south_wall.png

F 220,100,222
C 225,30,0

        1111111111111111111111111
        1000000000110000000N00001
        1011000001110000000000001
        1001000000010000000000001
111111111011000001110000000000001
100000000011000001111111111111111
11110111111111011100000010001
11110111111111000001010010001
11000000110101011100000010001
10000000000000000000000010001
10000000000000001101010010001
1100000111010101111101011000111
11110111 1110101 101110010001
11111111 1111111 1111111111111

